BACKGROUND_NAME level3_bg.png
IMAGE_NAME level3_tile.png
TILE_COUNT 16
0 0 128 128
128 0 128 128
256 0 128 128
384 0 128 128
0 128 128 128
128 128 128 128
256 128 128 128
384 128 128 128
0 256 128 128
128 256 128 128
256 256 128 128
384 256 128 128
0 384 128 128
128 384 128 128
256 384 128 128
384 384 128 128
CHEST_DETAILS 250 150 100
GRID 16 12
06 00 00 00 00 00 00 00 00 00 00 00 00 00 00 04
06 00 00 00 00 00 00 00 00 00 00 00 00 00 00 04
06 00 00 00 00 00 00 00 00 00 00 00 00 00 00 04
06 00 00 00 00 00 00 00 00 00 00 00 00 00 00 04
06 00 00 00 00 00 00 00 00 00 00 00 00 00 00 04
06 00 00 00 00 00 00 00 00 00 00 00 00 00 00 04
06 00 00 00 00 00 00 00 00 00 00 00 00 00 00 04
06 00 00 00 00 00 00 00 00 01 02 03 00 00 00 04
10 02 02 02 03 00 00 00 00 04 05 06 00 01 07 08
05 05 05 05 06 00 00 00 00 04 05 10 02 08 05 05
05 05 05 05 10 02 03 00 00 04 05 05 05 05 05 05
05 05 05 05 05 05 10 02 02 02 02 02 02 02 07 08