BACKGROUND_NAME level1_bg.png
IMAGE_NAME level1_tile.png
TILE_COUNT 16
0 0 128 128
128 0 128 128
256 0 128 128
384 0 128 128
0 128 128 128
128 128 128 128
256 128 128 128
384 128 128 128
0 256 128 128
128 256 128 128
256 256 128 128
384 256 128 128
0 384 128 128
128 384 128 128
256 384 128 128
384 384 128 128
CHEST_DETAILS 60 60 100
GRID 16 12
06 00 00 00 00 00 00 00 00 00 00 00 00 00 00 04
06 00 00 00 00 00 00 00 00 00 00 00 00 00 00 04
06 00 00 00 00 00 00 00 00 00 00 00 00 00 00 04
06 00 00 00 00 00 00 00 00 00 00 00 00 00 00 04
06 00 00 00 00 00 00 00 00 00 00 00 00 00 00 04
06 00 00 00 00 13 14 15 00 00 00 00 00 00 00 04
06 00 00 00 00 00 00 00 00 00 00 00 00 01 07 08
06 00 02 00 00 00 00 00 00 00 00 00 00 12 09 05
06 00 13 14 15 00 00 00 00 00 00 00 00 00 00 04
06 00 00 00 00 00 00 13 14 14 15 00 00 00 00 04
06 00 00 00 00 00 00 00 00 00 00 00 00 00 00 04
10 11 02 02 02 02 02 02 02 02 02 02 02 02 07 08