IMAGE_NAME level1_tile.png
TILE_COUNT 16
32 32 32 32
96 0 32 32
128 0 32 32
160 0 32 32
96 32 32 32
128 32 32 32
160 32 32 32
96 64 32 32
128 64 32 32
160 64 32 32
320 0 32 32
IMPASSABLE 2
00
10
GRID 16 9
01 02 02 02 02 02 02 02 02 02 02 02 02 02 02 03
04 05 05 05 05 05 10 05 05 05 05 05 05 05 05 06
04 05 05 05 05 05 05 05 05 05 05 05 05 05 05 06
04 05 05 05 05 05 05 05 05 10 05 05 05 05 05 06
04 05 10 05 05 05 05 05 05 05 05 05 05 05 05 06
04 05 05 05 05 05 05 05 05 05 05 10 05 05 05 06
04 05 05 05 05 05 05 05 10 05 05 05 05 05 05 06
04 05 05 05 05 05 05 05 05 05 05 10 05 05 05 06
07 08 08 08 08 08 08 08 08 08 08 08 08 08 08 09